10 10
XXXXXXXXXX
XOOOOOOOOX
XXXXOXXXOX
XOOOOXSOOX
XOXXOXOXOX
XOOEXORXOX
XOXXOXOXOX
XOXXOOXXXX
XOOOOXXXXX
XXXXXXXXXX