11 11
XXXXXXXXXXX
XSOOOOOOOOX
XXXXOXXXOXX
XOOOOXOOOXX
XOXXOXOXOXX
XOOEXORXOXX
XOXXOXOXOXX
XOXXOOXXOOX
XOOOOXXXXXX
XXXXOOOOOXX
XXXXXXXXXXX